###############
#-----------@-#
#-------------#
#---------B---#
#--@----------#
#--------B----#
#-------------#
#-------------#
#-----------@-#
#-------------#
#-------------#
#---B---------#
#-------------#
#-----------P-#
############### 
