##########
#--------#
#--B-----#
#---@----#
#--------#
#--B--P--#
#-----B--#
#--------#
#--@----@#
########## 